SOAK - Bloodbuzz Ohio
Illiterate Light - Sometimes Love Takes So Long 
HAIM - Hallelujah 
Joseph Arthur - Mayor Of The Lower East Side 
Joshua Radin - I Won’t Back Down 
Logan Ledger - River Of Fools 
Thom Yorke & Flea - Daily Battles 
Foy Vance - I Won’t Let You Fall 
Lucy Dacus - Fool’s Gold 
Thomas Dybdahl - 45
Wilsen - Ruiner 
The Teskey Brothers - Carry You 
Destroyer - Crimson Tide 
Anna Tivel - Worthless 
Jesse Malin - Chemical Heart 
William Prince - The Spark 
Aimee Mann - Hold On 
The Pernice Brothers - The Devil And The Jinn 
King Princess - Hit The Back 
Caribou - Home 
Chadwick Stokes and the Pintos - Hit The Bell With Your Elbow 
Drive-By Truckers - Armageddon’s Back In Town 
Madison Cunningham - Trouble Found Me 
Wye Oak - Fortune 
Bakar - Hell N Back 
Sudan Archives - Confessions 
Matt Berninger featuring Phoebe Bridgers - Walking On A String 
Beck - Stratosphere 
Whitney - Used To Be Lonely 
Grace Potter featuring Lucius - Desire 
Pete Yorn - On Your Side 
Peter Yorn - Long Way Down 
Pete Yorn - POV 
The Naked And Famous - Sunseeker 
@Mandolin Orange - Belly Of The Beast 
Beach Bunny - Prom Queen 
The Milk Carton Kids - The Only Ones 
Charly Bliss - Supermoon 
Grimes - So Heavy I Fell Through The Earth 
Patrick Watson - Dream For Dreaming 
Liza Anne - Devotion 
John Paul White - Fight For You 
John Paul White - Simple Song 
John Paul White - The Good Old Days 
OJR - Cosmic American Blues 
Rain Phoenix - You Right 
Shura - Religion (You Can Lay Your Hands On Me)
Big Thief - Not 
Billy Strings - Running 
Nane - Always On My Mind 
Dar Williams - The Christians And The Pagans 